ward,precinct,registered,polling,absentee,provisional,house,total
01,01,995,268,20,0,0,288
01,02,1112,292,31,0,0,323
01,03,1270,319,34,2,1,356
01,04,887,293,10,0,0,303
01,05,1066,341,27,0,0,368
01,06,1234,336,37,0,0,373
01,07,126,34,3,0,0,37
02,01,285,73,5,0,0,78
02,02,285,48,2,0,0,50
02,03,1119,299,16,0,0,315
02,04,739,203,12,0,0,215
02,05,1087,402,34,0,0,436
02,06,13,1,1,0,0,2
02,07,1057,410,40,0,0,450
02,08,1338,331,17,0,0,348
03,01,280,91,4,0,0,95
03,02,906,302,18,0,0,320
03,03,665,151,18,0,0,169
03,04,843,196,7,0,0,203
03,05,656,148,13,0,0,161
03,06,781,178,16,0,0,194
03,07,986,240,10,0,0,250
03,08,585,145,10,0,0,155
03,09,490,111,23,0,0,134
04,01,713,183,33,0,0,216
04,02,1639,395,26,0,0,421
04,03,620,160,6,0,0,166
04,04,960,272,18,0,0,290
04,05,770,197,12,0,0,209
04,06,559,118,8,0,0,126
04,07,795,242,17,0,0,259
04,08,177,43,3,0,0,46
04,09,149,38,1,0,0,39
04,10,240,65,4,0,0,69
05,01,531,131,28,0,0,159
05,02,556,133,7,0,0,140
05,03,800,214,46,0,0,260
05,04,492,147,7,0,0,154
05,05,716,182,6,0,0,188
05,06,951,228,27,10,1,266
05,07,875,227,22,0,0,249
05,08,404,61,16,0,0,77
06,01,795,304,13,1,0,318
06,02,735,334,16,0,0,350
06,03,952,327,6,0,0,333
06,04,994,457,17,0,0,474
06,05,408,161,14,0,0,175
06,06,833,287,19,0,0,306
06,07,1244,485,19,0,0,504
06,08,969,257,42,0,0,299
06,09,133,46,2,1,0,49
07,01,624,231,10,0,0,241
07,02,569,204,4,0,0,208
07,03,533,224,10,0,0,234
07,04,1317,388,27,2,0,417
07,05,1440,506,24,0,0,530
07,06,1670,561,19,0,0,580
08,01,904,394,10,1,0,405
08,02,736,263,11,0,0,274
08,03,577,218,9,2,0,229
08,04,1302,601,17,1,0,619
08,05,1372,536,31,0,0,567
08,06,78,19,0,0,0,19
08,07,476,188,14,0,1,203
08,08,791,358,25,0,0,383
08,09,850,318,16,0,0,334
09,01,1006,254,18,0,0,272
09,02,1278,308,22,2,0,332
09,03,763,304,5,1,0,310
09,04,554,217,9,0,0,226
09,05,664,232,5,1,0,238
09,06,833,185,10,0,0,195
09,07,68,12,2,0,0,14
09,08,350,100,4,0,0,104
09,09,284,114,4,0,0,118
10,01,1117,412,18,0,1,431
10,02,999,365,18,0,0,383
10,03,888,322,9,0,0,331
10,04,1060,357,11,0,0,368
10,05,1002,283,7,0,0,290
10,06,170,70,2,0,0,72
10,07,997,294,10,1,0,305
10,09,36,8,1,0,0,9
10,10,144,51,0,0,0,51
11,01,735,166,6,0,0,172
11,02,1038,427,13,0,0,440
11,03,771,143,7,0,0,150
11,04,1141,353,26,0,0,379
11,05,1099,280,49,0,0,329
11,06,970,284,15,0,0,299
12,01,697,229,8,0,0,237
12,02,1444,509,33,0,0,542
12,03,712,269,9,0,0,278
12,04,1282,487,16,0,0,503
12,05,1460,524,25,0,1,550
12,06,1548,517,34,0,0,551
12,08,80,22,0,0,0,22
12,09,46,15,0,0,0,15
13,01,1481,465,38,0,0,503
13,02,1377,510,23,0,0,533
13,03,1080,266,16,0,0,282
13,04,1211,474,9,0,0,483
13,06,1121,285,13,0,0,298
13,07,54,19,1,0,0,20
14,01,861,342,16,0,0,358
14,02,796,220,9,0,0,229
14,03,901,289,22,0,0,311
14,04,1211,428,13,0,0,441
14,05,559,134,2,0,0,136
14,06,998,295,9,0,0,304
14,07,86,22,2,0,0,24
14,08,53,23,0,0,0,23
14,09,368,71,9,0,0,80
15,01,1075,398,18,0,0,416
15,02,1348,567,19,0,0,586
15,03,1524,564,22,0,0,586
15,04,838,183,5,0,0,188
15,05,1134,378,24,0,0,402
15,06,634,161,5,0,0,166
15,07,4,1,0,0,0,1
16,01,1036,403,24,1,0,428
16,02,1126,482,41,0,0,523
16,03,1129,458,15,0,0,473
16,04,1173,494,18,0,0,512
16,05,1103,412,24,0,0,436
16,06,951,441,13,0,0,454
16,07,946,393,22,0,1,416
16,08,435,142,8,0,0,150
17,01,570,188,6,0,0,194
17,02,427,142,5,0,0,147
17,03,65,132,2,1,0,135
17,04,1093,309,50,0,0,359
17,05,1584,643,42,0,0,685
17,06,1133,268,25,1,0,294
17,07,30,4,1,0,0,5
17,08,938,332,22,0,0,354
18,01,1276,408,76,0,0,484
18,02,909,262,17,0,0,279
18,03,206,68,1,0,0,69
18,04,978,301,15,0,0,316
18,05,922,263,44,0,0,307
18,06,926,242,29,0,0,271
19,01,1009,349,15,0,0,364
19,02,57,2,1,0,0,3
19,03,290,108,7,0,0,115
19,04,647,273,6,1,0,280
19,05,1340,242,22,0,0,264
19,06,753,199,13,0,0,212
19,07,152,50,11,0,0,61
19,08,618,152,31,1,0,184
19,09,517,107,15,0,0,122
20,01,1082,224,7,0,0,231
20,02,571,155,5,2,0,162
20,03,1164,302,9,0,0,311
20,04,662,165,5,0,0,170
20,05,1088,262,11,0,0,273
20,06,251,41,3,0,0,44
20,07,305,81,8,0,0,89
21,01,630,141,19,0,0,160
21,02,908,298,15,0,0,313
21,03,870,227,14,0,0,241
21,04,945,311,34,0,0,345
21,05,809,218,15,5,0,238
21,06,887,302,16,1,0,319
21,07,561,155,9,0,0,164
21,08,727,237,12,0,0,249
21,09,904,265,25,0,0,290
22,01,505,126,4,0,0,130
22,02,1166,268,20,0,1,289
22,03,1134,315,29,1,0,345
22,04,796,210,35,1,0,246
22,05,735,185,13,0,0,198
22,06,1144,336,14,0,0,350
22,07,521,105,5,0,0,110
22,08,187,43,4,0,0,47
23,01,1426,537,15,0,0,552
23,02,1114,419,29,0,0,448
23,03,736,316,11,0,0,327
23,04,1069,432,18,0,0,450
23,05,861,355,14,0,0,369
23,06,837,329,11,1,0,341
23,07,830,306,19,0,0,325
23,08,839,333,9,0,0,342
23,09,261,99,6,0,0,105
24,01,963,351,14,0,0,365
24,02,690,252,6,1,0,259
24,03,826,264,15,0,0,279
24,04,1060,391,10,0,0,401
24,05,1093,369,17,0,0,386
24,06,1058,420,12,0,0,432
24,07,983,334,15,1,0,350
24,08,314,106,5,0,0,111
25,01,1225,313,15,0,0,328
25,02,1382,388,17,0,0,405
25,03,720,168,4,0,0,172
25,04,1363,359,11,1,0,371
25,05,537,112,2,0,0,114
25,06,27,2,0,0,0,2
26,01,755,287,12,0,0,299
26,02,642,195,16,0,0,211
26,03,1652,561,26,0,1,588
26,04,1212,368,48,0,0,416
26,05,1023,348,14,0,0,362
26,06,957,317,51,0,0,368
27,01,1175,387,23,0,0,410
27,02,830,213,10,0,0,223
27,03,1072,291,12,0,0,303
27,04,950,202,13,0,0,215
27,05,676,175,18,0,0,193
27,06,1202,298,18,2,0,318
27,07,1095,414,32,0,0,446
27,08,683,225,16,0,0,241
28,01,575,252,15,1,0,268
28,02,493,200,18,0,0,218
28,04,526,223,14,0,0,237
28,05,927,330,15,0,0,345
28,06,794,351,16,1,0,368
28,07,597,241,10,2,0,253
28,08,982,368,28,0,0,396
28,09,443,183,9,0,0,192
28,10,966,423,33,1,0,457
