ward,precinct,registered,polling,absentee,provisional,house,total
01,01,948,243,22,0,0,265
01,02,1021,291,25,0,0,316
01,03,1107,285,29,0,0,314
01,04,902,244,11,0,0,255
01,05,1001,295,32,0,0,327
01,06,1276,331,55,0,0,386
01,07,120,20,5,0,0,25
02,01,280,51,4,1,0,56
02,02,251,28,1,0,0,29
02,03,1044,280,13,0,0,293
02,04,616,162,12,0,0,174
02,05,1076,397,41,0,0,438
02,06,18,1,0,0,0,1
02,07,1006,349,60,1,0,410
02,08,1284,337,16,3,0,356
03,01,289,111,4,0,0,115
03,02,877,286,12,0,0,298
03,03,506,126,29,0,0,155
03,04,823,192,13,0,0,205
03,05,611,123,6,1,0,130
03,06,685,175,12,0,0,187
03,07,950,235,13,0,0,248
03,08,545,104,12,0,0,116
03,09,471,126,18,0,0,144
04,01,664,171,42,0,0,213
04,02,1450,347,23,1,0,371
04,03,600,159,4,0,0,163
04,04,924,218,16,0,0,234
04,05,725,194,15,0,0,209
04,06,516,121,8,1,0,130
04,07,754,196,16,0,0,212
04,08,161,27,3,0,0,30
04,09,136,50,2,0,0,52
04,10,237,39,5,0,0,44
05,01,407,106,24,0,0,130
05,02,579,139,6,0,0,145
05,03,873,193,34,9,0,236
05,04,488,141,5,0,0,146
05,05,829,132,7,8,0,147
05,06,1016,237,24,0,0,261
05,07,1030,271,25,1,0,297
05,08,505,107,31,0,0,138
06,01,905,350,28,0,0,378
06,02,762,372,28,1,0,401
06,03,1043,402,13,0,0,415
06,04,1032,457,29,0,0,486
06,05,483,193,9,7,0,209
06,06,884,265,14,0,0,279
06,07,1372,592,32,4,0,628
06,08,997,230,25,1,0,256
06,09,111,41,1,1,0,43
07,01,676,271,12,0,0,283
07,02,643,247,11,0,0,258
07,03,620,264,21,1,0,286
07,04,1793,569,38,1,0,608
07,05,1488,485,33,0,0,518
07,06,1740,668,36,1,0,705
08,01,1050,499,27,1,0,527
08,02,788,319,13,0,0,332
08,03,668,275,16,0,0,291
08,04,1430,690,38,1,0,729
08,05,1465,720,40,0,0,760
08,06,78,25,2,0,0,27
08,07,527,229,15,0,0,244
08,08,844,396,37,0,0,433
08,09,860,384,27,0,0,411
09,01,1079,325,17,0,0,342
09,02,1293,296,26,0,0,322
09,03,821,359,14,0,0,373
09,04,574,269,7,0,0,276
09,05,729,335,13,0,0,348
09,06,905,257,13,1,0,271
09,07,69,2,3,0,0,5
09,08,391,166,4,0,0,170
09,09,328,138,6,0,0,144
10,01,1254,534,28,0,0,562
10,02,1041,461,12,0,0,473
10,03,924,360,22,0,0,382
10,04,1120,501,19,0,0,520
10,05,1092,415,12,0,0,427
10,06,191,97,1,0,0,98
10,07,1045,437,14,1,0,452
10,09,50,10,1,0,0,11
10,10,168,74,4,0,0,78
11,01,773,223,9,0,0,232
11,02,1099,518,26,0,1,545
11,03,752,164,9,0,0,173
11,04,1195,393,22,0,0,415
11,05,1103,334,43,0,1,378
11,06,976,333,16,0,0,349
12,01,719,276,12,0,0,288
12,02,1556,608,33,0,0,641
12,03,783,348,16,0,1,365
12,04,1344,607,21,1,0,629
12,05,1532,701,32,1,0,734
12,06,1633,587,43,0,0,630
12,08,77,26,2,0,0,28
12,09,47,15,0,0,0,15
13,01,1574,630,32,0,0,662
13,02,1477,730,43,0,0,773
13,03,1140,345,13,0,0,358
13,04,1270,623,20,0,0,643
13,06,1201,393,21,0,0,414
13,07,44,4,1,0,0,5
14,01,909,443,17,0,0,460
14,02,813,267,10,0,0,277
14,03,994,290,25,0,0,315
14,04,1290,555,20,0,0,575
14,05,542,156,9,1,0,166
14,06,998,347,14,1,0,362
14,07,90,49,2,0,0,51
14,08,49,18,1,0,0,19
14,09,346,94,14,0,0,108
15,01,1178,552,26,2,0,580
15,02,1431,735,39,0,0,774
15,03,1615,767,35,0,0,802
15,04,853,254,5,0,0,259
15,05,1201,541,13,1,0,555
15,06,643,197,4,0,0,201
15,07,4,2,0,0,0,2
16,01,1064,472,29,0,0,501
16,02,1189,631,26,0,1,658
16,03,1167,581,16,0,0,597
16,04,1228,592,27,0,0,619
16,05,1187,538,18,0,0,556
16,06,988,539,33,0,0,572
16,07,973,487,20,0,0,507
16,08,470,181,9,0,0,190
17,01,641,266,11,0,0,277
17,02,537,175,13,0,0,188
17,03,57,10,2,0,0,12
17,04,1038,278,30,0,0,308
17,05,1873,677,61,0,0,738
17,06,1414,480,53,0,0,533
17,07,32,9,0,0,0,9
17,08,1084,343,37,0,0,380
18,01,1362,476,52,1,0,529
18,02,1046,316,15,0,1,332
18,03,234,56,2,0,0,58
18,04,918,280,14,0,0,294
18,05,909,290,56,0,0,346
18,06,961,249,26,0,1,276
19,01,1115,394,24,0,0,418
19,02,64,12,3,0,0,15
19,03,314,93,6,2,0,101
19,04,665,264,12,1,0,277
19,05,984,90,20,0,0,110
19,06,823,267,24,0,0,291
19,07,199,57,3,0,0,60
19,08,594,168,18,0,0,186
19,09,511,101,20,0,0,121
20,01,935,217,5,1,0,223
20,02,529,146,6,1,0,153
20,03,1179,306,15,0,0,321
20,04,620,177,5,0,0,182
20,05,1119,308,15,0,0,323
20,06,189,43,3,0,0,46
20,07,338,82,8,0,0,90
21,01,571,137,6,0,0,143
21,02,837,262,20,0,0,282
21,03,804,198,11,0,0,209
21,04,914,255,28,0,0,283
21,05,760,208,12,0,0,220
21,06,815,272,23,0,0,295
21,07,538,151,14,1,0,166
21,08,703,189,17,0,0,206
21,09,782,241,21,0,0,262
22,01,445,103,1,1,0,105
22,02,965,233,17,0,0,250
22,03,1141,295,18,1,0,314
22,04,766,239,24,1,0,264
22,05,695,174,17,0,0,191
22,06,1119,286,27,0,0,313
22,07,430,109,3,0,0,112
22,08,159,31,1,0,0,32
23,01,1440,668,22,0,0,690
23,02,1102,501,36,0,0,537
23,03,760,351,18,1,0,370
23,04,1109,513,17,0,0,530
23,05,867,459,11,0,0,470
23,06,855,401,13,0,0,414
23,07,912,409,25,0,0,434
23,08,874,408,18,0,0,426
23,09,278,121,8,0,0,129
24,01,1035,463,24,0,0,487
24,02,714,345,19,0,0,364
24,03,849,340,8,0,0,348
24,04,1081,463,19,0,0,482
24,05,1105,494,21,4,0,519
24,06,1169,506,18,1,0,525
24,07,989,391,16,0,0,407
24,08,348,154,8,0,0,162
25,01,1219,333,22,0,0,355
25,02,1341,391,16,0,0,407
25,03,722,166,6,0,0,172
25,04,1379,397,15,0,0,412
25,05,504,145,4,0,0,149
25,06,17,6,1,0,0,7
26,01,739,286,11,5,0,302
26,02,632,179,20,0,0,199
26,03,1760,609,54,1,0,664
26,04,1268,392,52,0,0,444
26,05,1036,314,10,0,0,324
26,06,1076,310,48,0,0,358
27,01,1052,326,28,2,0,356
27,02,786,185,5,1,0,191
27,03,1013,237,11,0,0,248
27,04,819,170,8,0,0,178
27,05,658,146,13,0,0,159
27,06,1092,256,18,2,0,276
27,07,1052,393,31,2,0,426
27,08,652,215,21,0,0,236
28,01,700,297,24,0,0,321
28,02,458,226,24,0,0,250
28,04,515,235,34,0,0,269
28,05,1012,303,30,0,0,333
28,06,823,359,28,0,0,387
28,07,613,256,15,0,0,271
28,08,1033,377,30,2,0,409
28,09,507,237,11,0,0,248
28,10,1016,419,52,0,0,471
