ward,precinct,registered,polling,absentee,provisional,house,total
01,01,1003,446,29,2,0,477
01,02,1094,435,48,0,0,483
01,03,1157,460,43,0,0,503
01,04,944,432,21,2,0,455
01,05,1052,518,55,0,0,573
01,06,1339,523,74,2,0,599
01,07,128,22,7,0,0,29
02,01,295,95,9,0,0,104
02,02,279,87,1,1,0,89
02,03,1139,511,40,3,0,554
02,04,643,295,20,2,0,317
02,05,1101,582,56,0,0,638
02,06,16,1,0,0,0,1
02,07,1038,526,65,3,0,594
02,08,1343,582,29,0,0,611
03,01,320,192,7,0,0,199
03,02,897,409,28,0,0,437
03,03,537,205,36,0,0,241
03,04,899,389,20,0,0,409
03,05,630,233,8,0,0,241
03,06,749,290,33,0,0,323
03,07,992,412,19,0,0,431
03,08,561,196,18,0,0,214
03,09,487,204,15,0,0,219
04,01,692,274,58,1,0,333
04,02,1577,640,39,0,0,679
04,03,629,287,14,0,0,301
04,04,966,432,23,1,0,456
04,05,779,304,27,0,0,331
04,06,532,227,14,0,0,241
04,07,797,336,24,0,0,360
04,08,170,63,4,0,0,67
04,09,149,79,2,0,0,81
04,10,257,87,8,0,0,95
05,01,418,196,26,0,0,222
05,02,609,236,13,0,0,249
05,03,949,394,45,0,0,439
05,04,528,245,8,0,0,253
05,05,846,299,17,0,0,316
05,06,1150,517,47,0,1,565
05,07,1155,610,112,0,1,723
05,08,593,252,57,0,0,309
06,01,944,585,30,0,0,615
06,02,793,549,80,0,0,629
06,03,1135,673,43,0,0,716
06,04,1051,622,68,0,0,690
06,05,578,300,37,0,0,337
06,06,973,522,44,0,0,566
06,07,1481,955,78,0,0,1033
06,08,1046,466,47,1,0,514
06,09,123,74,3,0,0,77
07,01,703,433,22,0,0,455
07,02,713,436,28,0,0,464
07,03,669,455,77,0,0,532
07,04,2047,1157,152,1,0,1310
07,05,1565,908,84,0,0,992
07,06,1911,1234,109,1,0,1344
08,01,1142,777,50,0,0,827
08,02,814,537,27,2,0,566
08,03,721,469,34,1,0,504
08,04,1553,1091,73,0,0,1164
08,05,1566,1102,82,0,0,1184
08,06,83,31,3,0,0,34
08,07,558,358,40,1,0,399
08,08,896,597,68,5,0,670
08,09,918,569,58,0,0,627
09,01,1148,584,20,0,0,604
09,02,1375,594,34,1,0,629
09,03,883,591,46,3,0,640
09,04,618,432,30,0,0,462
09,05,772,504,30,0,0,534
09,06,986,491,24,0,0,515
09,07,78,13,3,0,0,16
09,08,416,267,11,0,0,278
09,09,332,241,16,0,0,257
10,01,1323,898,57,1,0,956
10,02,1083,702,47,0,0,749
10,03,979,637,41,0,0,678
10,04,1179,800,27,2,0,829
10,05,1177,722,30,0,0,752
10,06,206,151,7,0,0,158
10,07,1111,722,30,0,0,752
10,09,56,20,0,0,0,20
10,10,174,117,6,0,0,123
11,01,805,370,12,0,0,382
11,02,1146,717,47,0,0,764
11,03,819,338,13,6,0,357
11,04,1257,645,28,2,0,675
11,05,1148,579,58,2,0,639
11,06,1031,531,32,1,0,564
12,01,731,433,23,0,0,456
12,02,1596,944,58,0,0,1002
12,03,802,513,28,1,0,542
12,04,1406,967,38,1,0,1006
12,05,1591,1105,70,0,0,1175
12,06,1703,1039,76,0,0,1115
12,08,82,54,0,0,0,54
12,09,49,18,0,0,0,18
13,01,1641,986,48,0,0,1034
13,02,1530,1065,66,2,0,1133
13,03,1194,624,25,0,0,649
13,04,1321,899,51,0,0,950
13,06,1248,663,27,0,0,690
13,07,63,8,2,0,0,10
14,01,958,703,28,4,0,735
14,02,831,455,12,0,0,467
14,03,1042,525,42,0,0,567
14,04,1358,866,43,0,0,909
14,05,574,259,14,0,0,273
14,06,1043,585,19,0,0,604
14,07,97,71,2,0,0,73
14,08,47,26,1,0,0,27
14,09,359,170,18,0,0,188
15,01,1239,832,63,0,0,895
15,02,1514,1065,94,0,0,1159
15,03,1690,1182,72,0,0,1254
15,04,908,454,20,1,0,475
15,05,1286,830,44,0,0,874
15,06,668,342,16,0,0,358
15,07,5,1,0,0,0,1
16,01,1104,761,51,0,0,812
16,02,1232,891,67,0,0,958
16,03,1203,874,51,0,0,925
16,04,1273,882,62,0,0,944
16,05,1248,888,44,0,0,932
16,06,1012,732,69,0,0,801
16,07,1020,730,52,0,0,782
16,08,497,302,23,0,0,325
17,01,724,309,37,1,0,347
17,02,650,379,38,3,0,420
17,03,77,165,4,0,0,169
17,04,1177,635,65,3,0,703
17,05,2130,1341,187,2,0,1530
17,06,1576,908,89,3,0,1000
17,07,34,6,0,0,0,6
17,08,1239,694,81,2,0,777
18,01,1506,873,100,0,0,973
18,02,1145,526,25,0,0,551
18,03,240,122,3,0,0,125
18,04,1003,447,30,0,0,477
18,05,948,423,74,11,0,508
18,06,1075,448,52,3,0,503
19,01,1204,694,64,1,0,759
19,02,68,47,2,0,0,49
19,03,335,161,10,10,0,181
19,04,726,401,34,0,0,435
19,05,1203,474,23,2,0,499
19,06,913,488,45,3,0,536
19,07,232,109,11,1,0,121
19,08,641,298,27,0,0,325
19,09,562,263,26,0,0,289
20,01,1014,454,9,0,0,463
20,02,560,290,15,1,0,306
20,03,1248,584,16,0,0,600
20,04,675,353,8,0,0,361
20,05,1200,585,16,0,0,601
20,06,211,90,3,0,0,93
20,07,367,177,14,0,0,191
21,01,580,224,12,0,0,236
21,02,900,400,26,0,0,426
21,03,811,350,22,0,0,372
21,04,965,449,32,0,1,482
21,05,774,319,27,1,0,347
21,06,827,418,34,1,0,453
21,07,550,261,14,1,0,276
21,08,717,307,28,0,0,335
21,09,841,334,23,0,0,357
22,01,461,180,5,0,0,185
22,02,1053,431,27,0,0,458
22,03,1273,495,41,0,0,536
22,04,831,407,33,0,0,440
22,05,760,319,20,0,0,339
22,06,1179,509,41,1,0,551
22,07,463,190,12,0,0,202
22,08,162,60,2,0,0,62
23,01,1495,1043,31,0,0,1074
23,02,1147,794,68,0,0,862
23,03,773,542,24,0,0,566
23,04,1159,806,46,0,1,853
23,05,904,637,35,0,0,672
23,06,884,624,23,0,0,647
23,07,953,676,55,0,0,731
23,08,911,633,35,0,0,668
23,09,295,188,10,0,0,198
24,01,1109,762,50,0,0,812
24,02,758,520,35,0,0,555
24,03,882,513,23,0,0,536
24,04,1121,766,25,0,0,791
24,05,1138,760,31,0,0,791
24,06,1233,827,40,1,0,868
24,07,1089,708,43,1,2,754
24,08,373,272,13,0,0,285
25,01,1296,594,27,0,0,621
25,02,1384,713,38,0,0,751
25,03,779,328,19,0,0,347
25,04,1448,692,32,1,0,725
25,05,518,268,13,0,0,281
25,06,19,4,1,0,0,5
26,01,797,452,27,0,0,479
26,02,694,294,28,1,0,323
26,03,1946,1105,95,0,0,1200
26,04,1329,617,87,1,0,705
26,05,1099,549,21,0,0,570
26,06,1183,575,72,1,0,648
27,01,1085,524,50,0,0,574
27,02,824,318,7,1,0,326
27,03,1064,473,16,0,0,489
27,04,862,315,17,2,0,334
27,05,698,259,24,0,0,283
27,06,1145,497,22,0,0,519
27,07,1095,570,55,0,0,625
27,08,686,318,26,1,0,345
28,01,803,550,65,2,0,617
28,02,472,305,39,3,0,347
28,04,567,396,55,2,0,453
28,05,1120,537,74,4,0,615
28,06,911,553,62,0,0,615
28,07,665,437,59,0,0,496
28,08,1150,692,85,0,0,777
28,09,573,376,48,0,0,424
28,10,1073,669,111,0,0,780
