date,ward,precinct,registered,polling,absentee,provisional,house,total
2015-04-07,01,01,1005,81,13,0,0,94
2015-04-07,01,02,1123,88,20,0,0,108
2015-04-07,01,03,1266,58,21,0,0,79
2015-04-07,01,04,921,73,9,0,0,82
2015-04-07,01,05,1081,95,19,0,0,114
2015-04-07,01,06,1261,93,16,0,0,109
2015-04-07,01,07,130,6,1,0,0,7
2015-04-07,02,01,287,11,5,0,0,16
2015-04-07,02,02,291,9,2,0,0,11
2015-04-07,02,03,1143,116,6,0,0,122
2015-04-07,02,04,754,81,6,0,0,87
2015-04-07,02,05,1096,201,26,0,0,227
2015-04-07,02,06,14,11,0,0,0,11
2015-04-07,02,07,1062,193,22,0,0,215
2015-04-07,02,08,1359,165,18,0,0,183
2015-04-07,03,01,288,20,1,0,0,21
2015-04-07,03,02,928,88,8,0,0,96
2015-04-07,03,03,679,34,16,0,0,50
2015-04-07,03,04,874,16,3,0,0,19
2015-04-07,03,05,675,35,7,0,0,42
2015-04-07,03,06,793,64,8,0,0,72
2015-04-07,03,07,989,63,3,0,0,66
2015-04-07,03,08,608,27,9,0,0,36
2015-04-07,03,09,502,30,10,0,0,40
2015-04-07,04,01,709,72,32,0,1,105
2015-04-07,04,02,1682,106,22,0,0,128
2015-04-07,04,03,637,47,5,0,0,52
2015-04-07,04,04,989,102,6,0,0,108
2015-04-07,04,05,786,65,10,0,0,75
2015-04-07,04,06,566,44,7,0,0,51
2015-04-07,04,07,814,80,12,0,1,93
2015-04-07,04,08,183,18,1,0,0,19
2015-04-07,04,09,150,9,2,0,0,11
2015-04-07,04,10,244,12,1,0,0,13
2015-04-07,05,01,536,26,18,0,0,44
2015-04-07,05,02,575,25,2,0,0,27
2015-04-07,05,03,819,58,30,0,0,88
2015-04-07,05,04,498,19,2,0,0,21
2015-04-07,05,05,743,33,3,0,0,36
2015-04-07,05,06,998,66,11,0,0,77
2015-04-07,05,07,916,28,6,0,0,34
2015-04-07,05,08,438,17,10,0,0,27
2015-04-07,06,01,823,102,6,0,0,108
2015-04-07,06,02,749,140,2,0,0,142
2015-04-07,06,03,964,114,3,0,0,117
2015-04-07,06,04,1008,207,11,0,0,218
2015-04-07,06,05,419,90,13,0,0,103
2015-04-07,06,06,860,150,7,0,0,157
2015-04-07,06,07,1274,161,7,0,0,168
2015-04-07,06,08,990,143,9,0,0,152
2015-04-07,06,09,133,12,1,0,0,13
2015-04-07,07,01,636,60,4,0,0,64
2015-04-07,07,02,589,54,4,0,0,58
2015-04-07,07,03,551,233,11,0,0,244
2015-04-07,07,04,1362,70,7,0,0,77
2015-04-07,07,05,1493,198,16,0,0,214
2015-04-07,07,06,1765,154,14,0,0,168
2015-04-07,08,01,945,129,6,0,0,135
2015-04-07,08,02,744,65,6,0,0,71
2015-04-07,08,03,596,62,3,0,0,65
2015-04-07,08,04,1359,170,10,0,0,180
2015-04-07,08,05,1399,162,13,0,0,175
2015-04-07,08,06,85,3,0,0,0,3
2015-04-07,08,07,479,54,10,0,0,64
2015-04-07,08,08,834,117,14,0,0,131
2015-04-07,08,09,870,79,5,0,0,84
2015-04-07,09,01,1032,67,7,0,0,74
2015-04-07,09,02,1324,63,16,0,0,79
2015-04-07,09,03,790,66,2,0,0,68
2015-04-07,09,04,567,36,1,0,0,37
2015-04-07,09,05,667,42,2,0,0,44
2015-04-07,09,06,873,45,2,0,0,47
2015-04-07,09,07,69,1,0,0,0,1
2015-04-07,09,08,365,25,1,0,0,26
2015-04-07,09,09,299,17,2,0,0,19
2015-04-07,10,01,1142,95,11,0,0,106
2015-04-07,10,02,1016,148,9,0,0,157
2015-04-07,10,03,909,132,4,0,0,136
2015-04-07,10,04,1076,88,6,0,0,94
2015-04-07,10,05,1033,57,0,0,0,57
2015-04-07,10,06,174,35,1,0,0,36
2015-04-07,10,07,1023,67,3,0,0,70
2015-04-07,10,09,39,1,1,0,0,2
2015-04-07,10,10,147,8,0,0,0,8
2015-04-07,11,01,746,29,5,0,0,34
2015-04-07,11,02,1046,86,4,0,0,90
2015-04-07,11,03,794,25,9,0,0,34
2015-04-07,11,04,1168,78,16,0,0,94
2015-04-07,11,05,1131,60,3,0,0,63
2015-04-07,11,06,994,65,6,0,0,71
2015-04-07,12,01,703,47,9,0,0,56
2015-04-07,12,02,1456,115,23,0,0,138
2015-04-07,12,03,734,63,3,0,0,66
2015-04-07,12,04,1299,118,12,0,0,130
2015-04-07,12,05,1480,107,11,0,0,118
2015-04-07,12,06,1570,96,30,0,0,126
2015-04-07,12,08,81,6,0,0,0,6
2015-04-07,12,09,51,2,1,0,0,3
2015-04-07,13,01,1493,119,21,0,0,140
2015-04-07,13,02,1386,104,14,0,0,118
2015-04-07,13,03,1089,52,10,0,0,62
2015-04-07,13,04,1225,104,3,0,0,107
2015-04-07,13,06,1136,67,8,0,0,75
2015-04-07,13,07,61,2,1,0,0,3
2015-04-07,14,01,862,48,11,0,0,59
2015-04-07,14,02,810,46,4,0,0,50
2015-04-07,14,03,923,122,6,0,0,128
2015-04-07,14,04,1229,75,6,0,0,81
2015-04-07,14,05,565,39,5,0,0,44
2015-04-07,14,06,1009,65,4,0,0,69
2015-04-07,14,07,87,5,3,0,0,8
2015-04-07,14,08,50,6,0,0,0,6
2015-04-07,14,09,366,18,5,0,0,23
2015-04-07,15,01,1092,125,7,0,0,132
2015-04-07,15,02,1380,182,5,0,0,187
2015-04-07,15,03,1551,187,14,0,0,201
2015-04-07,15,04,856,59,5,0,0,64
2015-04-07,15,05,1163,121,11,0,0,132
2015-04-07,15,06,647,50,5,0,0,55
2015-04-07,15,07,4,0,0,0,0,0
2015-04-07,16,01,1046,92,17,0,0,109
2015-04-07,16,02,1149,108,14,0,0,122
2015-04-07,16,03,1132,75,7,0,0,82
2015-04-07,16,04,1184,107,7,0,0,114
2015-04-07,16,05,1106,73,6,0,0,79
2015-04-07,16,06,962,109,6,0,0,115
2015-04-07,16,07,960,84,15,0,0,99
2015-04-07,16,08,453,33,2,0,0,35
2015-04-07,17,01,588,48,3,0,0,51
2015-04-07,17,02,441,20,2,0,0,22
2015-04-07,17,03,69,1,2,0,0,3
2015-04-07,17,04,1127,66,29,0,0,95
2015-04-07,17,05,1654,129,18,0,0,147
2015-04-07,17,06,1195,83,11,0,0,94
2015-04-07,17,07,29,1,0,0,0,1
2015-04-07,17,08,943,79,7,0,0,86
2015-04-07,18,01,1295,137,54,0,0,191
2015-04-07,18,02,949,99,8,0,0,107
2015-04-07,18,03,209,18,0,0,0,18
2015-04-07,18,04,997,88,10,0,0,98
2015-04-07,18,05,934,98,37,0,0,135
2015-04-07,18,06,953,91,18,0,0,109
2015-04-07,19,01,1040,70,6,0,0,76
2015-04-07,19,02,57,2,0,0,0,2
2015-04-07,19,03,287,48,4,0,0,52
2015-04-07,19,04,670,82,5,0,0,87
2015-04-07,19,05,1323,26,12,0,0,38
2015-04-07,19,06,779,64,14,0,0,78
2015-04-07,19,07,158,6,6,0,0,12
2015-04-07,19,08,631,34,5,0,0,39
2015-04-07,19,09,532,26,9,0,0,35
2015-04-07,20,01,1110,118,5,0,0,123
2015-04-07,20,02,598,84,7,0,0,91
2015-04-07,20,03,1231,191,11,0,0,202
2015-04-07,20,04,680,121,1,0,0,122
2015-04-07,20,05,1142,197,12,0,0,209
2015-04-07,20,06,253,25,3,0,0,28
2015-04-07,20,07,319,41,7,0,0,48
2015-04-07,21,01,634,42,16,0,0,58
2015-04-07,21,02,927,72,12,0,0,84
2015-04-07,21,03,873,71,12,0,0,83
2015-04-07,21,04,955,110,17,0,0,127
2015-04-07,21,05,811,63,10,0,0,73
2015-04-07,21,06,903,97,11,0,0,108
2015-04-07,21,07,564,35,8,0,0,43
2015-04-07,21,08,754,51,10,0,1,62
2015-04-07,21,09,911,74,17,0,0,91
2015-04-07,22,01,509,40,2,0,0,42
2015-04-07,22,02,1163,106,10,0,0,116
2015-04-07,22,03,1165,131,14,0,0,145
2015-04-07,22,04,818,83,30,0,0,113
2015-04-07,22,05,747,68,12,0,0,80
2015-04-07,22,06,1169,122,12,0,0,134
2015-04-07,22,07,522,47,4,0,0,51
2015-04-07,22,08,187,12,5,0,0,17
2015-04-07,23,01,1455,87,6,0,0,93
2015-04-07,23,02,1123,67,12,0,0,79
2015-04-07,23,03,747,43,4,0,0,47
2015-04-07,23,04,1083,69,9,0,0,78
2015-04-07,23,05,879,53,4,0,0,57
2015-04-07,23,06,854,50,3,0,0,53
2015-04-07,23,07,840,47,11,0,0,58
2015-04-07,23,08,844,48,3,0,0,51
2015-04-07,23,09,255,15,3,0,0,18
2015-04-07,24,01,981,120,4,0,0,124
2015-04-07,24,02,708,92,4,0,0,96
2015-04-07,24,03,832,62,8,0,0,70
2015-04-07,24,04,1067,113,9,0,0,122
2015-04-07,24,05,1093,57,8,0,0,65
2015-04-07,24,06,1087,115,3,0,0,118
2015-04-07,24,07,993,89,7,0,0,96
2015-04-07,24,08,327,23,3,0,0,26
2015-04-07,25,01,1270,66,14,0,0,80
2015-04-07,25,02,1395,66,13,0,0,79
2015-04-07,25,03,738,33,4,0,0,37
2015-04-07,25,04,1398,82,8,0,0,90
2015-04-07,25,05,554,26,3,0,0,29
2015-04-07,25,06,26,0,0,0,0,0
2015-04-07,26,01,779,91,15,0,0,106
2015-04-07,26,02,677,65,16,0,0,81
2015-04-07,26,03,1712,179,32,0,0,211
2015-04-07,26,04,1225,113,46,0,0,159
2015-04-07,26,05,1044,115,3,0,0,118
2015-04-07,26,06,994,106,32,0,0,138
2015-04-07,27,01,1181,104,17,0,0,121
2015-04-07,27,02,843,48,2,0,0,50
2015-04-07,27,03,1082,70,6,0,0,76
2015-04-07,27,04,955,40,10,0,0,50
2015-04-07,27,05,689,39,13,0,0,52
2015-04-07,27,06,1225,77,14,0,0,91
2015-04-07,27,07,1100,119,15,0,0,134
2015-04-07,27,08,699,86,13,0,0,99
2015-04-07,28,01,592,79,7,0,0,86
2015-04-07,28,02,490,70,9,0,0,79
2015-04-07,28,04,545,58,2,0,0,60
2015-04-07,28,05,936,94,3,0,0,97
2015-04-07,28,06,792,115,6,0,0,121
2015-04-07,28,07,611,67,0,0,0,67
2015-04-07,28,08,1021,141,13,0,0,154
2015-04-07,28,09,447,51,2,0,0,53
2015-04-07,28,10,975,137,9,0,0,146
